00000000000000000000000000000000000000000000000010
00000000000000000000000000000000000000000000000110
00000000000000000000000000000000000000000000000000
00000000000000000000000000000000000000000000001110
00000000000000000000000000000000000000000000011110
00000000000000000000000000000000000000000000111100
00000000000000000000000000000000000000000011111000
00000000000000000000000000000000000000000011110000
00000000000000000000000000000000000000000111100000
00000000000000000000000000000000000000001111000000
00000000000000000000000000000000000000011110000000
00000000000000000000000000000000000000111100000000
00000000000000000000000000000000000001111000000000
00000000000000000000000000000000000011110000000000
00000000000000000000000000000000000111100000000000
00000000000000000000000000000000001111000000000000
00000000000000000000000000000000011100000000000000
00000000000000000000000000000000111100000000000000
00000000000000000000000000000001111000000000000000
00000000000000000000000000000011110000000000000000
00000000000000000000000000000111100000000000000000
00000000000000000000000000001111000000000000000000
00000000000000000000000000001110000000000000000000
00000000000000000000000001111000000000000000000000
00000000000000000000000001100000000000000000000000
00000000000000000000000110000000000000000000000000
00000000000000000000000110000000000000000000000000
00000000000000000000000100000000000000000000000000
00000000000000000000011100000000000000000000000000
00000000000000000000111000000000000000000000000000
00000000000000000001111000000000000000000000000000
00000000000000000011110000000000000000000000000000
00000000000000000111100000000000000000000000000000
00000000000000001111000000000000000000000000000000
00000000000000011110000000000000000000000000000000
00000000000000111100000000000000000000000000000000
00000000000001110000000000000000000000000000000000
00000000000011110000000000000000000000000000000000
00000000000111100000000000000000000000000000000000
00000000001111000000000000000000000000000000000000
00000000011110000000000000000000000000000000000000
00000000111100000000000000000000000000000000000000
00000011111000000000000000000000000000000000000000
00000011110000000000000000000000000000000000000000
00000111100000000000000000000000000000000000000000
00001111000000000000000000000000000000000000000000
00011110000000000000000000000000000000000000000000
01011100000000000000000000000000000000000000000000
11011000000000000000000000000000000000000000000000
00000000000000000000000000000000000000000000000000
